Stage 1
######
#  P #
#o####
# #
#O#
###
======
Stage 2
######
# P  #
#  oO#
# Oo #
######
======
Stage 3
#####
#P  ##
#Oo0 #
#  # #
#    #
######
======
Stage 4
######
#P   ##
# oo  #
# #O O#
#     #
#######
=======
Stage 5
  ####
###  #
#P Oo##
#   o #
# #O  #
#     #
#######